00000000000000000000000000000000000000000000000000000000000000000000000000000000000000000000000000000000000000000000020000000000
00000000000000000000000000000000000000000000000000000000011111110000000000000000000000000000000000000000000000000111111110000000
00000000000000000000000000000000000000000000000000000000000000000000000000000003333300000000000000000000000000000000000310000000
00000000000002000000020000000000000000000000000000000000000000000000000000000001111100000000000000000000000000000000000310000000
00000011111111111111111111110000000000000000000000000000000000000000000000000000010000000000000000000000000000000000000310000000
00000000000000000000000000000000000000000000000020000000000000000000000000000000010000000000000000000000000000000000000310000000
00000000000000000000000000000000000000000000111111111000000000000000000000000000010000000000000000000000000000000000000310000000
00000000020000000000000003330000000000000000000000001100000000000000000000000000010020000000000000000000000000000000000310000000
00000111111111111000000001110000000000000000000013333310000000000000000000000001111111111000000000000000000000000000000310000000
00000000000000000000000000000000000000000000000011111111000000000000000000000000000000000000000000000000000000000000000310000000
00000000000000000000000000000000000000000000000000000000100000000000000000000000203000000000000000000000000000000000000310000000
00000000000000000000000000000000000000000000000000000000010000000000000000011111111100000000000000000000000000000000000110000000
00000030000000000000000000000000000000003000000000000000000000000000333000000000000000000000000000000000000000000000000000000000
00111111000000000000000000000000000000000000000000000000000000000011111100000000000000000000000000200000000000000000000000000000
00000000000600000200000000020000333333000000000000000000003333000000000000000000000000000000001111111100000000330200000000000000
00000100001100111111110011111111000000111110000000000001111111110000000000000000000000000000000000000000000111111111111110000000
00000000000000000000000000000000000000000000000000000000000000000000000000000000000000000000000000000000000000000000000000000000
00000000000000000000000000000000000000000000000000000000000000000000000000000000000000000000000000000000000000000000000000000000