00000000000000000000000000000000
00000000000000000000000000000000
00000000000000000000000000000000
00000000000002000000020000000000
00000011111111111111111111110000
00000000000000000000000000000000
00000000000000000000000000000000
00000000020000000000000000000000
00000111111111111000000001110000
00000000000000000000000000000000
00000000000000000000000000000000
00000000000000000000000000000000
00000030000000000000000000000000
00111111000000000000000000000000
00000000000000000200000000020000
00000100001100111111110011111111
00000000000000000000000000000000
00000000000000000000000000000000