00000000000000000000000000000000
00000000000000000220000000000000
00000011111111111111111111110000
00000000000000000000000000000000
00000000000000000000000000000000
00000000020020000000000000000000
00000111111111111000000001110000
00000000000000000000000000000000
00000000000000000000000000000000
00000000000000000000000000000000
00000030000000000000000000000000
00111111000000000000000000000000
00000000000000000000000000000000
00000000000000000000000000000000
00000000000000000020000000020000
00000000001100100111110000110000
00000000000000000000000000000000
00200000000000000000000000000000